XXXXXXXXXXXXXXXXXXXXXXXXXXXXXXXXXXXXXXXXXXXXXXXXXXXXXXXXXXXXXXX
X                                                             X
X                                                             X
X                                                             X
X                                                             X
X                                                             X
X                                                             X
X                                                             X
X                                                             X
X                                                             X
X                                                             X
X                                                             X
X                                                             X
X                                                             X
X                                                             X
X                                                             X
X                                                             X
X                                                             X
X                                                             X
X                                                             X
X                                                             X
X                                                             X
X                                                             X
X                                                             X
X                                                             X
X                                                             X
X                      XXXXXXXXXXXXXXXXXXXXXXXX               X
X         XXXXXXXXX                                           X
X                                                             X
XXXXXXXXXXXXXXXXXXXXXXXXXXXXXXXXXXXXXXXXXXXXXXXXXXXXXXXXXXXXXXX